Ability - способность
Able - способный
Absolutely - абсолютно
Actually - фактически
Admit - признавать
Advice - совет
Alert - тревога
Alternate - чередовать
Although - несмотря на то что, хотя
Amount - сумма
Announce - объявить
Anyway - в любом случае
Appear - приближаться/появляться
Approach - приближение
Area - площадь
Arrive - прибывать
As soon - как только
Attempt - попытка
Attention - внимание
Awake - проснуться
Awere - осведомлен

Bar - плитка
Basic - основной.
Beat - взбить/бить
Below - ниже
Being - существование
Besides - кроме того
Bisect - делить пополам
Blame - вина
Blind - слепой
Bored - скучающий
Bottom - дно, низ, внизу
By the time - к тому времени
Browsre - просматривать

Calm - спокойный
Cannot - нельзя
Checked - клеточный
Circle - круг
Collapse - крах
Common - общий
Communication - общение
Conclusion - вывод
Consume - потреблять
Contain - содержать
Cover - покрытие
Crowded - переполненный
Currently - в настоящий момент
Current - текущий
Certain - определенный

Dazzle me - удиви меня
Deadline - крайний срок
Dedicated - посвященный
Deliver - доставлять
Deside - решать
Desk job - работа в офисе
Despite - несмотря на
Destiny - судьба
Different way - по другому
Disappear - пропадать
Disappointed - разочарованный
Disastrous - катострофический 
Doubts - сомнения
Downstairs - вниз по лестнице
Drip - Капать
Duration - продолжительность
Definitely - однозначно
Directory - каталог

East - восток
Emergency - чрезвычайная ситуация
Enough - достаточно
Estimated - оцененный
Exactly - именно так
Exception - Исключение
Excited - возбужденный
Exhausted - измученный
Expect - кроме
Explain - объяснять
Event - событие
Enviroment - окружающая среда, окружение
Exists - существует

Fault - ошибка
Feedback - обратная связь
Few - несколько
Fill - заполнять
Font - шрифт
Forbidden - Запрещено
Fortunately - к счастью
Framework - рамки
Funny - смешной, забавный
Furniture - мебель

Genuinely - искренне
Give up - сдаваться
Goofy - глупый
Grand - великий, роскошный
Grate - натереть
Greetings - приветствую

Happy - счастливый
Height - высота
Hold - держать
Honor - честь, уважение, почесть
However - однако 
Huge - огромный

I agree - я согласен
I feel that way too - Я тоже так чувствую
I second that - я поддерживаю это 
Immediately - немедленно
Impact - влияние
Impossible - невозможно
Intermediate - промежуточный
International - международный
Introduce - вводить 	
Introducing - введение
Invalid - неправильно
Issues - вопросы
Intention - намерение

Kind - тип

Literally - буквально
Litre - литр
Loaf - буханка
Lonely - одинокий

Mad - безумный
Manage - управлять
Melt - растопить
Memorize - запомнить, выучить наизусть
Might - вероятно
Modern - современный

Not bad - неплохо
Notification - уведомление
Notify - уведомлять

Opinion - мнение
Origin - истоки/происхождение
Outlet - выход
Offer - предложение
One more time - еще раз

Pale - бледный
Part-time - неполная занятость
Pass - сдать / пройти
Pattern - узор/шаблон
Pay rise - повышение зарплаты
Peel - чистить
Pinch of salt - щепотка соли
Pleasure - удовольствие
Polka dot - в горошек
Possible - возможно
Pour - налитьы
Pressure - давление
Probably - вероятно
Prohibition - Запрет
Promise - обещать
Prediction - предсказание
Puppy - щенок

Raise - поднимать
Realize - осознавать
Reason - причина
Recall - вспоминать
Recently - недавно
Recognize - распознавать, узнавать
Recover - Восстанавливаться
Rectangle - квадрат
Rectangular - прямоугольный
Refusal - отказ
Regret - желеть
Regret - сожалеть
Regard - уважение, отношение / warm regards - с теплыми пожеланиями
Relationships - отношения
Remind - напоминать
Remind - напомни
Reportedly - Сообщается
Represent - представлять
Resolve - решать
Response - ответ
Revelations - откровения
Right - правильно
Rise - подниматься
Request - запрос

Sad - грустный
Salary - зарплата
Scared - напуганный
Second-hand - подержанный
Separate - разделитель
Share - делиться
Sharp - острый
Shift - смена
Show - показывать
Similar - похожи
Sincerely - искренне
Size - размер
Slice - ломтик
Solitude - одиночество 
Soon - скоро 
Still - все еще
Striped - полосатый
Suddenly - внезапно
Sure - конечно
Surprised - удивленный
Survived - выживший

Teaspoon - чайная ложка
Thougt - мысль
Through - через
Tough - жесткий
Thunder - гром
Tiny - крошечный
Tough - жесткий
Towel - полотенце
Trade - торговля
Triangle - треугольник
Triangular - треугольны
Try out - попробуйте
Trust - доверять

Unfortunately - к сожалению
Unity - единство 
Unlike - непохож
Unpredictable - непредсказуемый
Upstairs - вверх по лестнице

Violent - грубый
Victim - жертва

Warning - предупреждение
We are of one mind - мы придерживаемся одного мнения
West - запад
What is that mean - что это значит 
Wherever - где бы
Width - ширина
Wise - мудрый
Wish - желаю
Wooden - деревянный
Woollen - шерстяной
Worry - беспокоиться 
Wrong - неправильно