Ability - способность
Able - способный
Absolutely - абсолютно
Actually - фактически
Admit - признавать
Advice - совет
Affect - влиять
Ahead - впереди
Alert - тревога
Allow - позволять
Alternate - чередовать
Although - несмотря на то что, хотя
Amazing - удивительный
Among - среди
Amount - сумма
Announce - объявлять
Anyway - в любом случае
Appear - приближаться/появляться
Approach - приближение
Area - площадь
Arrive - прибывать
As soon - как только
Assassin - убийца
Asshole - мудак
Attempt - попытка
Attention - внимание
Available - доступно
Awake - проснуться
Aware - осведомлен
Bakery - пекарня
Bar - плитка
Basic - основной
Bastard - ублюдок
Beat - взбить/бить
Being - существование
Below - ниже
Besides - кроме того
Bisect - делить пополам
Blade - нож, лезвие
Blame - вина
Blind - слепой
Bored - скучающий
Bottle - бутылка
Bottom - дно, низ, внизу
Bounds - границы
Brave - храбрый
Browse - просматривать
By the time - к тому времени
Calm - спокойный
Cannot - нельзя
Carefully - аккуратно
Certain - определенный
Certainly - определенно, конечно
Chase - преследовать
Checked - клеточный
Cheers - за ваше здоровье
Circle - круг
Collapse - крах
Common - общий
Communication - общение
Conclusion - вывод
Condition - состояние
Consume - потреблять
Contain - содержать
Conversation - разговор
Cover - покрытие
Crowded - переполненный
Current - текущий
Currently - в настоящий момент
Dash - тире, дефис
Data transmission - передача данных
Dazzle me - удиви меня
Deadline - крайний срок
Decide - решать
Dedicated - посвященный
Definitely - однозначно
Deliver - доставлять
Destroy - разрушать
Desk job - работа в офисе
Despite - несмотря на
Destination - место назначения
Destiny - судьба
Different way - по другому
Directory - каталог
Disable - отключить
Disappear - пропадать
Disappointed - разочарованный
Disastrous - катастрофический
Distribute - распространять, распределять
Diverge - отличаться, не совпадать
Doubts - сомнения
Downstairs - вниз по лестнице
Drip - Капать
Drive - диск, накопитель
Duration - продолжительность
Earning - заработок
East - восток
Emergency - чрезвычайная ситуация
Enhance - улучшить. Enhanced - улучшенный
Enough - достаточно
Entertainment - развлечение
Environment - окружающая среда, окружение
Equal - равно
Equipment - оборудование 
Especially - особенно
Essentially - существенно, значительно
Establish - установить
Estimated - оцененный
Event - событие
Exactly - именно так
Exception - исключение
Excited - возбужденный
Exhausted - измученный
Exists - существует
Expect - кроме
Expect - ожидать
Explain - объяснять
Explode - взорвать
Explosion - взрыв
Falcon - сокол
Fame - слава
Fancy - нарядный, модный, шикарный
Fault - ошибка
Feedback - обратная связь
Female - женский
Few - несколько
Fiber - волокно
Fill - заполнять
Font - шрифт
Forbidden - Запрещено
Fortunately - к счастью
Framework - рамки
Freak - чудак, фрик. Freaking - долбанный
Funny - смешной, забавный
Furniture - мебель
Gate - ворота
Genuinely - искренне
Give up - сдаваться
Globe - земной шар
Going to | Gonna - собираться
Goofy - глупый
Govern - править
Government - правительство
Grand - великий, роскошный
Greetings - приветствую
Guardian - страж
Happy - счастливый
Healthy - здоровый
Heat - жара
Height - высота
Hold - держать
Honest - честный
Honor - честь, уважение, почесть
However - однако
Huge - огромный
I agree - я согласен
I feel that way too - Я тоже так чувствую
I second that - я поддерживаю это
Immediately - немедленно
Impact - влияние
Impossible - невозможно
Improve - улучшать
Incredible - невероятно
Indeed - действительно
Initialize - инициализировать
Initially - первоначально
Inspection - анализ
Intention - намерение
Intermediate - промежуточный
International - международный
Introduce - вводить	 
Introducing - введение
Invalid - неправильно
Issues - вопросы
It’s not right - это неправильно
Jealousy - ревность
Kidnap - похищать
Kind - тип
Kinda - вроде
Kingdom - царство
Launch - запуск
Less - меньше
Lifestyle - образ жизни
Literally - буквально
Litre - литр
Loaf - буханка
Lonely - одинокий
Mad - безумный
Majestic - величественный
Male - мужской, мужчина
Manage - управлять
Melt - растопить
Memorize - запомнить, выучить наизусть
Might - вероятно
Mindset - образ мышления
Modern - современный
Necessary - необходимо
Neck - шея
Network - сеть - любая компьютерная сеть
Not bad - неплохо
Notification - уведомление
Notify - уведомлять
Nuclear - ядерный
Obscene words - непристойные слова
Obviously - очевидно
Offer - предложение
One more time - еще раз
Opinion - мнение
Opportunity - возможность
Opposite - противоположный
Optical fiber - оптоволокно
Organized - организованный
Origin - истоки/происхождение
Order - приказ
Outlet - выход
Pale - бледный
Part-time - неполная занятость
Pass - сдать / пройти
Pattern - узор/шаблон
Pay rise - повышение зарплаты
Payload - полезная нагрузка
Peel - чистить
Perhaps - возможно
Pinch of salt - щепотка соли
Pleasure - удовольствие
Pocket - карман
Polka dot - в горошек
Pollution - загрязнение
Possible - возможно
Pour - наливать
Prediction - предсказание
Pressure - давление
Print - печатать
Private insurance - частное страхование
Probably - вероятно
Prohibition - запрет
Promise - обещать
Public insurance - государственное страхование
Puppy - щенок
Quote - цитата
Raise - поднимать
Rather - скорее
Realize - осознавать
Reason - причина
Recall - вспоминать
Receive - получать
Receiver - получатель, приемник
Recently - недавно
Recognize - распознавать, узнавать
Recover - Восстанавливаться
Rectangle - квадрат
Rectangular - прямоугольный
Refresh - обновить
Refusal - отказ
Regard - уважение
Regard - уважение, отношение / warm regards - с теплыми пожеланиями
Regret - сожалеть
Relationships - отношения
Relative - родственник, сравнительный
Remind - напоминать
Remind - напомни
Reply - отвечать
Reportedly - cообщается
Replace - заменять
Represent - представлять
Request - запрос
Require - требовать. Requirement - требование
Resolution - разрешение
Resolve - решать
Response - ответ
Responsible - ответственный
Revelations - откровения
Revenge - месть
Right - правильно
Rise - подниматься
Sad - грустный
Salary - зарплата
Savage - дикарь
Scare - пугать
Schedule - график, расписание
Second-hand - подержанный
Seems - кажется
Semi - полу
Send - посылать
Separate - разделитель
Sequence - последовательность
Share - делиться
Share - делиться
Sharp - острый
Shemale - транссексуал
Shift - смена
Show - показывать
Similar - похожи
Sincerely - искренне
Size - размер
Slice - ломтик
Sniff - нюхать
Solid - твердый
Solitude - одиночество
Soon - скоро
Source - источник
Special - особый
Spit - плевать
Squash - раздавить
Statement - высказывание / утверждение
Still - все еще
Storage - хранилище
Stripe - полоса
Striped - полосатый
Sub - под, почти
Suddenly - внезапно
Sure - конечно
Surprised - удивленный
Survived - выживший
Suspect - подозревать
Switch - переключатель, переключать 
Switchblade - складной нож
Teaspoon - чайная ложка
Term - термин
There we go - вот так вот
Thought - мысль
Through - через
Thunder - гром
Tiny - крошечный
Top down - сверху вниз
Tough - жесткий
Towel - полотенце
Trade - торговля
Triangle - треугольник
Triangular - треугольный
Trick - трюк
Trust - доверять
Try out - попробуйте
Unfortunately - к сожалению
Unity - единство
Unlike - непохож
Unpredictable - непредсказуемый
Upset - расстроенный
Upstairs - вверх по лестнице
Useful - полезный
Useless - бесполезный
Vehicle - транспортное средство
Victim - жертва
Violent - грубый
Vocabulary - словарный запас
Wanna | Want to - хотеть
Waste - тратить
Warning - предупреждение
We are of one mind - мы придерживаемся одного мнения
Wealth - богатство
Weird - странный
West - запад
What is that mean - что это значит
Wherever - где бы
Width - ширина
Wise - мудрый
Wish - желаю
Wooden - деревянный
Woollen - шерстяной
Worry - беспокоиться
Wrong - неправильно